#########################################################################
#      $ $ $    #                                                       #
#  @            #                                                       #
#               #                                                       #
#               #                                                       #
#               #                                                       #
######-##########                                                       #
#                                                                       #
#                                                                       #
#                                                                       #
#                                                                       #
#                                                                       #
#                                                                       #
#                                                                       #
#                                                                       #
#                                                                       #
#                                                                       #
#                                                                       #
#                                                                       #
#                                                                       #
#                                                                       #
#                                                                       #
#                                                                       #
#                                                                       #
#                                                                       #
#                                                                       #
#                                                                       #
#                                                                       #
#                                                                       #
#                                                                       #
#                                                                       #
#########################################################################
