#########################################################################
#......$.$.$....#.......................................................#
#.@.............#.......................................................#
#...............#.......................................................#
#...............#.......................................................#
#...............#.......................................................#
######-##########.......................................................#
#.......................................................................#
#.......................................................................#
#.......................................................................#
#.......................................................................#
#.......................................................................#
#.......................................................................#
#.......................................................................#
#.......................................................................#
#.......................................................................#
#.......................................................................#
#.......................................................................#
#.......................................................................#
#.......................................................................#
#.......................................................................#
#.......................................................................#
#.......................................................................#
#.......................................................................#
#.......................................................................#
#.......................................................................#
#.......................................................................#
#.......................................................................#
#.......................................................................#
#.......................................................................#
#.......................................................................#
#########################################################################

