#########################################################################
#                                                                       #
#  @                                                                    #
#                                                                       #
#                                                                       #
#                                                                       #
#                                                                       #
#                                                                       #
#                                                                       #
#                                                                       #
#                                                                       #
#                                                                       #
#                                                                       #
#                                                                       #
#                                                                       #
#                                                                       #
#                                                                       #
#                                                                       #
#                                                                       #
#                                                                       #
#                                                                       #
#                                                                       #
#                                                                       #
#                                                                       #
#                                                                       #
#                                                                       #
#                                                                       #
#                                                                       #
#                                                                       #
#                                                                       #
#                                                                       #
#########################################################################
